10000000000000000000000000000000000000000000000000001
10000000000000000000000000000000000000000000000000001
10000000000000000000000000000000000000000000000000001
10000000000000000000000000000000000000000000000000001
10000000000000000000000000000000000000000000000000001
10000000000000000000000000000000000000000000000000001
10000000000000000000000000000000000000000000000000001
10000000000000000000000000000000000000000000000000001
10000000000000000000000000000000000000000000000000001
10000000000000000000000000000000000000000000000000001
10000000000000000000000000000000000000000000000000001
10000000000000000000000000000000000000000000000000001
10000000000000000000000000000000000000000000000000001
10000000000000000000000000000000000000000000000000001
10000000000000000000000000000000000000000000000000001
10000000000000000000000000000000000000000000000000001
10000000000000000000000000000000000000000000000000001
10000000000000000000000000000000000000000000000000001
10000000000000000000000000000000000000000000000000001
10000000000000000000000000000000000000000000000000001
10000000000000000000000000000000000000000000000000001
11111111111111111111111111111000001111111111111111111
00000000000000000000000000000000000000000000000000001
10000000000000000000000000000000000000000000000000001
10000000000000000000000000000000000000000000000000001
10000000000000000000000000000000000000000000000000001
10000000000000000000000000000000000000000000000000001
10000000000000000000000000000000000000000000000000001
10000000000000000000000000000000000000000000000000001
10000000000000000000000000000000000000000000000000001
10000000000000000000000000000000000000000000000000001
10000000000000000000000000000000000000000000000000001
10000000000000000000000000000000000000000000000000001
10000000000000000000000000000000000000000000000000001
11111111111111111100000111111111111111111111111111111
10000000000000000000000000000000000000000000000000001
10000000000000000000000000000000000000000000000000001
10000000000000000000000000000000000000000000000000001
10000000000000000000000000000000000000000000000000001
10000000000000000000000000000000000000000000000000001
10000000000000000000000000000000000000000000000000001
10000000000000000000000000000000000000000000000000001
10000000000000000000000000000000000000000000000000001
10000000000000000000000000000000000000000000000000001
10000000000000000000000000000000000000000000000000001
10000000000000000000000000000000000000000000000000001
11111111111111111111111111111000001111111111111111111
10000000000000000000000000000000000000000000000000001
10000000000000000000000000000000000000000000000000001
10000000000000000000000000000000000000000000000000001
10000000000000000000000000000000000000000000000000001
10000000000000000000000000000000000000000000000000001
10000000000000000000000000000000000000000000000000001
10000000000000000000000000000000000000000000000000001
10000000000000000000000000000000000000000000000000001
10000000000000000000000000000000000000000000000000001
10000000000000000000000000000000000000000000000000001
10000000000000000000000000000000000000000000000000001
11111111111111111111111111111111111111111111111111111